, "Total" , "Without Children" , "With Children and Adults" , "With Only Children" , "Unknown Household Type"
"""0 - 17""",10,0,10,0,0
"""18 - 24""",6,6,0,0,0
"""25 - 34""",22,18,4,0,0
"""35 - 44""",22,20,2,0,0
"""45 - 54""",28,27,1,0,0
"""55 - 61""",22,21,1,0,0
"""62 +""",23,23,0,0,0
"""Client Doesn't Know/Client Refused""",0,0,0,0,0
"""Data Not Collected""",0,0,0,0,0
"""Total""",133,115,18,0,0
